Time,MKAKLLVLLCAFTATDADTICIGYHANNSTDTVDTVLEKNVTVTHSVNLLEDSHNGKLCRLKGIAPLQLGNCSIAGWILGNPECESLFSKESWSYIAETPNSENGTCYPGYFADYEELREQLSSVSSFERFEIFPKESSWPNHTVTKGVTAACSHNGKSSFYRNLLWLTEKNGLYPNLSKSYVNNKEKEVLVLWGVHHPSNIGDQRAIYHTENAYVSVVSSHYSRRFTPEIAKRPKVRGQEGRINYYWTLLEPGDTIIFEANGNLIAPWYAFALSRGFGSGIITSNASMDECDAKCQTPQGAINSSLPFQNVHPVTIGECPKYVRSTKLRMVTGLRNIPSVQSRGLFGAIAGFIEGGWTGMIDGWYGYHHQNEQGSGYAADQKSTQNAINGITNKVNSVIEKMNTQFTAVGKEFNKLERRMENLNKKVDDGFLDIWTYNAELLVLLENERTLDFHDSNVKNLYEKVKSQLKNNAKEIGNGCFEFYHKCNNECMESVKNGTYDYPKYSEESKLNREKIDGVKLESMGVYQILAIYSTVASSLVLLVSLGAISFWMCSNGSLQCRICI,MKAKLLVLLCAFTATDADTICIGYHANNSTDTVDTVLEKNVTVTHSVNLLEDSHNGKLCRLKGIAPLQLGNCSIAGWILGNPECESLFSKESWSYIAETPNSENGTCYPGYFADYEELREQLSSVSSFERFEIFPKESSWPNHTVTKGVTAACSHNGKSSFYRNLLWLTEKYGLYPNLSKSYVNNKEKEVLVLWGVHHPSNIGDQRAIYHTENAYVSVVSSHYSRRFTPEIAKRPKVRGQEGRIEYYWTLLEPGDTIIFEANGNLIAPWYAFALSRGFGSGIITSNASMDECDAKCQTPQGAINSSLPFQNVHPVTIGECPKYVRSTKLRMVTGLRNIPSVQSRGLFGAIAGFIEGGWTGMIDGWYGYHHQNEQGSGYAADQKSTQNAINGITNKVNSVIEKMNTQFTAVGKEFNKLERRMENLNKKVDDGFLDIWTYNAELLVLLENERTLDFHDSNVKNLYEKVKSQLKNNAKEIGNGCFEFYHKCNNECMESVKNGTYDYPKYSEESKLNREKIDGVKLESMGVYQILAIYSTVASSLVLLVSLGAISFWMCSNGSLQCRICI,MKAKLLVLLCAFTATDADTICIGYHANNSTDTVDTVLEKNVTVTHSVNLLEDSHNGKLCRLKGIAPLQLGNCSIAGWILGNPECESLFSKESWSYIAETPNSENGTCYPGYFADYEELREQLSSVSSFERFEIFPKESSWPNHTVTKGVTAACSHNGKSSFYRNLLWLTEKNGLYPNLSKSYVNNKEKEVLVLWGVHHPSNIGDQRAIYHTENAYVSVVSSHYSRRFTPEIAKRPKVRGQEGRINYYWTLLEPGDTIIFEANGNLIAPWYAFALSRGFGSGIITSNASMDECDAKCQTPQGAINSSLPFQNVHPVTIGECPKYVRSTKLRMVTGLRNIPSVQSRGLFGAIAGFIEGGWTGMIDGWYGYHHQNEQGSGYAADQKSTQNAINGITNKVNSVIEKMNTQFTAVGKEFNKLERRMENLNEKVDDGFLDIWTYNAELLVLLENERTLDFHDSNVKNLYEKVKSQLKNNAKEIGNGCFEFYHKCNNECMESVKNGTYDYPKYSEESKLNREKIDGVKLESMGVYQILAIYSTVASSLVLLVSLGAISFWMCSNGSLQCRICI,MKAKLLVLLCAFTATDADTICIGYHANNSTDTVDTVLEKNVTVTHSVNLLEDSHNGKLCRLKGIAPLQLGNCSIAGWILGNPECESLFSKESWSYIAETPNSENGTCYPGYFADYEELREQLSSVSSFERFEIFPKESSWPNHTVTKGVTAACSHNGKSSFYRNLLWLTEKNGLYPNLSKSYVNNKEKEVLVLWGVHHPSNIGDQRAIYHTENAYVSVVSSHYSRRFTPEIAKRPKVRGQEGRINYYWTLLEPGDTIIFEANGNLIAPWYAFALSRGFGSGIITSNASMDECDAKCQTPQGAINSSLPFQNVHPVTIGECPKYVRSTKLRMVTGLRNIPSVQSRGLFGAIAGFIEGGWTGMIDGWIGYHHQNEQGSGYAADQKSTQNAINGITNKVNSVIEKMNTQFTAVGKEFNKLERRMENLNKKVDDGFLDIWTYNAELLVLLENERTLDFHDSNVKNLYEKVKSQLKNNAKEIGNGCFEFYHKCNNECMESVKNGTYDYPKYSEESKLNREKIDGVKLESMGVYQILAIYSTVASSLVLLVSLGAISFWMCSNGSLQCRICI,MKAKLLVLLCAFTATDADTICIGYHANNSTDTVDTVLEKNVTVTHSVNLLEDSHNGKLCRLKGIAPLQLGNCSIAGWILGNPECESLFSKESWSYIAETPNSENGTCYPGYFADYEELREQLSSVSSFERFEIFPKESSWPNHTVTKGVTAACSHNGKSSFYRNLLWLTEKNGLYPNLSKSYVNNKEKEVLVLWGVHHPSNIGDQRAIYHTENAYVSVVSSHYSRRFTPEIAKRPKVRGQEGRINYYWTLLEPGDTIIFEANGNLIAPWYAFALSRGFGSGIITSNAIMDECDAKCQTPQGAINSSLPFQNVHPVTIGECPKYVRSTKLRMVTGLRNIPSVQSRGLFGAIAGFIEGGWTGMIDGWYGYHHQNEQGSGYAADQKSTQNAINGITNKVNSVIEKMNTQFTAVGKEFNKLERRMENLNKKVDDGFLDIWTYNAELLVLLENERTLDFHDSNVKNLYEKVKSQLKNNAKEIGNGCFEFYHKCNNECMESVKNGTYDYPKYSEESKLNREKIDGVKLESMGVYQILAIYSTVASSLVLLVSLGAISFWMCSNGSLQCRICI,MKAKLLVLLCAFTATDADTICIGYHANNSTDTVDTVLEKNVTVTHSVNLLEDSHNGKLCRLKGIAPLQLGNCSIAGWILGNPECESLFSKESWSYIAETPNSENGTCYPGYFADYEELREQLSSVSSFERFEIFPKESSWPNHTVTKGVTAACSHNGKSSFYRNLLWLTEKNGLYPNLSKSYVNNKEKEVLVLWGVHHPSNIGDQRAIYHTENAYVSVVSSHYSRRFTPEIAKRPKVRGQEGRINYYWTLLEPGDTIIFEANGNLIAPWYAFALSRGFGSGIITSNASMDECDAKCQTPQGAINSSLPFFNVHPVTIGECPKYVRSTKLRMVTGLRNIPSVQSRGLFGAIAGFIEGGWTGMIDGWYGYHHQNEQGSGYAADQKSTQNAINGITNKVNSVIEKMNTQFTAVGKEFNKLERRMENLNKKVDDGFLDIWTYNAELLVLLENERTLDFHDSNVKNLYEKVKSQLKNNAKEIGNGCFEFYHKCNNECMESVKNGTYDYPKYSEESKLNREKIDGVKLESMGVYQILAIYSTVASSLVLLVSLGAISFWMCSNGSLQCRICI,MKAKLLVLLCAFTATDADTICIGYHANNSTDTVDTVLEKNVTVTHSVNLLEDSHNGKLCRLKGIAPLQLGNCSIAGWILGNPECESLFSKESWSYIAETPNSENGTCYPGYFADYEELREQLSSVSSFERFEIFPKESSWPNHTVTKGVTAACSHNGKSSFYRNLLWLTEKNGLYPNLSKSYVNNKEKEVLVLWGVHHPSNIGDQRAIYHTENAYVSVVSSHYSRRFTPEIAKRPKVRGQEGRINYYWTLLEPGDTIIFEANGNLIAPWYAFALSRGFGSGIITSNASMDECDTKCQTPQGAINSSLPFQNVHPVTIGECPKYVRSTKLRMVTGLRNIPSVQSRGLFGAIAGFIEGGWTGMIDGWYGYHHQNEQGSGYAADQKSTQNAINGITNKVNSVIEKMNTQFTAVGKEFNKLERRMENLNKKVDDGFLDIWTYNAELLVLLENERTLDFHDSNVKNLYEKVKSQLKNNAKEIGNGCFEFYHKCNNECMESVKNGTYDYPKYSEESKLNREKIDGVKLESMGVYQILAIYSTVASSLVLLVSLGAISFWMCSNGSLQCRICI,Other,Total
0.0,0,0,0,0,0,0,0,0,0
2.0,0,0,0,0,0,0,0,0,0
4.0,0,0,0,0,0,0,0,0,0
6.0,0,0,0,0,0,0,0,0,0
8.0,0,0,0,0,0,0,0,0,0
10.0,0,0,0,0,0,0,0,1,1
12.0,0,0,0,0,0,0,0,2,2
14.0,2,0,0,0,0,0,0,5,7
16.0,12,1,0,1,0,0,1,15,30
18.0,22,1,0,1,0,0,1,37,62
20.0,30,0,0,0,0,0,1,68,99
22.0,27,0,1,0,1,1,1,89,120
24.0,26,0,1,0,1,1,1,95,125
26.0,24,0,1,0,1,1,1,82,110
28.0,23,0,0,0,1,1,0,72,97
30.0,19,0,0,0,1,1,0,61,82
32.0,18,0,0,0,1,1,0,55,75
34.0,16,0,0,0,1,1,0,47,65
36.0,15,0,0,0,1,1,0,44,61
38.0,14,0,0,0,1,1,0,35,51
40.0,14,0,0,0,1,1,0,32,48
42.0,14,0,0,0,1,1,0,29,45
44.0,14,0,0,0,1,1,0,26,42
46.0,13,0,0,0,0,1,0,26,40
48.0,13,0,0,0,0,1,0,26,40
50.0,10,0,0,0,0,1,0,24,35
52.0,10,0,0,0,0,0,0,24,34
54.0,9,0,0,0,0,0,0,23,32
56.0,9,0,0,0,0,0,0,23,32
58.0,9,0,0,0,0,0,0,21,30
60.0,8,0,0,0,0,0,0,21,29
62.0,7,0,0,0,0,0,0,21,28
64.0,7,0,0,0,0,0,0,20,27
66.0,7,0,0,0,0,0,0,20,27
68.0,7,0,0,0,0,0,0,20,27
70.0,7,0,0,0,0,0,0,20,27
72.0,7,0,0,0,0,0,0,20,27
74.0,7,0,0,0,0,0,0,20,27
76.0,7,0,0,0,0,0,0,20,27
78.0,7,0,0,0,0,0,0,20,27
80.0,7,0,0,0,0,0,0,20,27
82.0,7,0,0,0,0,0,0,20,27
84.0,7,0,0,0,0,0,0,20,27
86.0,7,0,0,0,0,0,0,20,27
88.0,7,0,0,0,0,0,0,20,27
90.0,7,0,0,0,0,0,0,20,27
92.0,7,0,0,0,0,0,0,20,27
94.0,7,0,0,0,0,0,0,20,27
96.0,7,0,0,0,0,0,0,20,27
98.0,7,0,0,0,0,0,0,20,27
100.0,7,0,0,0,0,0,0,20,27
102.0,7,0,0,0,0,0,0,20,27
104.0,7,0,0,0,0,0,0,20,27
106.0,7,0,0,0,0,0,0,20,27
108.0,7,0,0,0,0,0,0,20,27
110.0,7,0,0,0,0,0,0,20,27
112.0,7,0,0,0,0,0,0,20,27
114.0,7,0,0,0,0,0,0,20,27
116.0,7,0,0,0,0,0,0,20,27
118.0,7,0,0,0,0,0,0,20,27
120.0,7,0,0,0,0,0,0,20,27
122.0,7,0,0,0,0,0,0,20,27
124.0,7,0,0,0,0,0,0,20,27
126.0,7,0,0,0,0,0,0,20,27
128.0,7,0,0,0,0,0,0,20,27
130.0,7,0,0,0,0,0,0,20,27
132.0,7,0,0,0,0,0,0,20,27
134.0,7,0,0,0,0,0,0,20,27
136.0,7,0,0,0,0,0,0,20,27
138.0,7,0,0,0,0,0,0,20,27
140.0,7,0,0,0,0,0,0,20,27
142.0,7,0,0,0,0,0,0,20,27
144.0,7,0,0,0,0,0,0,20,27
146.0,7,0,0,0,0,0,0,20,27
148.0,7,0,0,0,0,0,0,20,27
150.0,7,0,0,0,0,0,0,20,27
152.0,7,0,0,0,0,0,0,20,27
154.0,7,0,0,0,0,0,0,20,27
156.0,7,0,0,0,0,0,0,20,27
158.0,7,0,0,0,0,0,0,20,27
160.0,7,0,0,0,0,0,0,20,27
162.0,7,0,0,0,0,0,0,20,27
164.0,7,0,0,0,0,0,0,20,27
166.0,7,0,0,0,0,0,0,20,27
168.0,7,0,0,0,0,0,0,20,27
170.0,7,0,0,0,0,0,0,20,27
172.0,7,0,0,0,0,0,0,20,27
174.0,7,0,0,0,0,0,0,20,27
176.0,7,0,0,0,0,0,0,20,27
178.0,7,0,0,0,0,0,0,20,27
180.0,7,0,0,0,0,0,0,20,27
182.0,7,0,0,0,0,0,0,20,27
184.0,7,0,0,0,0,0,0,20,27
186.0,7,0,0,0,0,0,0,20,27
188.0,7,0,0,0,0,0,0,20,27
190.0,7,0,0,0,0,0,0,20,27
192.0,7,0,0,0,0,0,0,20,27
194.0,7,0,0,0,0,0,0,20,27
196.0,7,0,0,0,0,0,0,20,27
198.0,7,0,0,0,0,0,0,20,27
200.0,7,0,0,0,0,0,0,20,27
202.0,7,0,0,0,0,0,0,20,27
204.0,7,0,0,0,0,0,0,20,27
206.0,7,0,0,0,0,0,0,20,27
208.0,7,0,0,0,0,0,0,20,27
210.0,7,0,0,0,0,0,0,20,27
212.0,7,0,0,0,0,0,0,20,27
214.0,7,0,0,0,0,0,0,20,27
216.0,7,0,0,0,0,0,0,20,27
218.0,7,0,0,0,0,0,0,20,27
220.0,7,0,0,0,0,0,0,20,27
222.0,7,0,0,0,0,0,0,20,27
224.0,7,0,0,0,0,0,0,20,27
226.0,7,0,0,0,0,0,0,20,27
228.0,7,0,0,0,0,0,0,20,27
230.0,7,0,0,0,0,0,0,20,27
232.0,7,0,0,0,0,0,0,20,27
234.0,7,0,0,0,0,0,0,20,27
236.0,7,0,0,0,0,0,0,20,27
238.0,7,0,0,0,0,0,0,20,27
240.0,7,0,0,0,0,0,0,20,27
242.0,7,0,0,0,0,0,0,20,27
244.0,7,0,0,0,0,0,0,20,27
246.0,7,0,0,0,0,0,0,20,27
248.0,7,0,0,0,0,0,0,20,27
250.0,7,0,0,0,0,0,0,20,27
252.0,7,0,0,0,0,0,0,20,27
254.0,7,0,0,0,0,0,0,20,27
256.0,7,0,0,0,0,0,0,20,27
258.0,7,0,0,0,0,0,0,20,27
260.0,7,0,0,0,0,0,0,20,27
262.0,7,0,0,0,0,0,0,20,27
264.0,7,0,0,0,0,0,0,20,27
266.0,7,0,0,0,0,0,0,20,27
268.0,7,0,0,0,0,0,0,20,27
270.0,7,0,0,0,0,0,0,20,27
272.0,7,0,0,0,0,0,0,20,27
274.0,7,0,0,0,0,0,0,20,27
276.0,7,0,0,0,0,0,0,20,27
278.0,7,0,0,0,0,0,0,20,27
280.0,7,0,0,0,0,0,0,20,27
282.0,7,0,0,0,0,0,0,20,27
284.0,7,0,0,0,0,0,0,20,27
286.0,7,0,0,0,0,0,0,20,27
288.0,7,0,0,0,0,0,0,20,27
290.0,7,0,0,0,0,0,0,20,27
292.0,7,0,0,0,0,0,0,20,27
294.0,7,0,0,0,0,0,0,20,27
296.0,7,0,0,0,0,0,0,20,27
298.0,7,0,0,0,0,0,0,20,27
300.0,7,0,0,0,0,0,0,20,27
302.0,7,0,0,0,0,0,0,20,27
304.0,7,0,0,0,0,0,0,20,27
306.0,7,0,0,0,0,0,0,20,27
308.0,7,0,0,0,0,0,0,20,27
310.0,7,0,0,0,0,0,0,20,27
312.0,7,0,0,0,0,0,0,20,27
314.0,7,0,0,0,0,0,0,20,27
316.0,7,0,0,0,0,0,0,20,27
318.0,7,0,0,0,0,0,0,20,27
320.0,7,0,0,0,0,0,0,20,27
322.0,7,0,0,0,0,0,0,20,27
324.0,7,0,0,0,0,0,0,20,27
326.0,7,0,0,0,0,0,0,20,27
328.0,7,0,0,0,0,0,0,20,27
330.0,7,0,0,0,0,0,0,20,27
332.0,7,0,0,0,0,0,0,20,27
334.0,7,0,0,0,0,0,0,20,27
336.0,7,0,0,0,0,0,0,20,27
338.0,7,0,0,0,0,0,0,20,27
340.0,7,0,0,0,0,0,0,20,27
342.0,7,0,0,0,0,0,0,20,27
344.0,7,0,0,0,0,0,0,20,27
346.0,7,0,0,0,0,0,0,20,27
348.0,7,0,0,0,0,0,0,20,27
350.0,7,0,0,0,0,0,0,20,27
352.0,7,0,0,0,0,0,0,20,27
354.0,7,0,0,0,0,0,0,20,27
356.0,7,0,0,0,0,0,0,20,27
358.0,7,0,0,0,0,0,0,20,27
360.0,7,0,0,0,0,0,0,20,27
362.0,7,0,0,0,0,0,0,20,27
364.0,7,0,0,0,0,0,0,20,27
