Time,MKAKLLVLLCAFTATDADTICIGYHANNSTDTVDTVLEKNVTVTHSVNLLEDSHNGKLCRLKGIAPLQLGNCSIAGWILGNPECESLFSKESWSYIAETPNSENGTCYPGYFADYEELREQLSSVSSFERFEIFPKESSWPNHTVTKGVTAACSHNGKSSFYRNLLWLTEKNGLYPNLSKSYVNNKEKEVLVLWGVHHPSNIGDQRAIYHTENAYVSVVSSHYSRRFTPEIAKRPKVRGQEGRINYYWTLLEPGDTIIFEANGNLIAPWYAFALSRGFGSGIITSNASMDECDAKCQTPQGAINSSLPFQNVHPVTIGECPKYVRSTKLRMVTGLRNIPSVQSRGLFGAIAGFIEGGWTGMIDGWYGYHHQNEQGSGYAADQKSTQNAINGITNKVNSVIEKMNTQFTAVGKEFNKLERRMENLNKKVDDGFLDIWTYNAELLVLLENERTLDFHDSNVKNLYEKVKSQLKNNAKEIGNGCFEFYHKCNNECMESVKNGTYDYPKYSEESKLNREKIDGVKLESMGVYQILAIYSTVASSLVLLVSLGAISFWMCSNGSLQCRICI,MKAKLLVLLCAFTATDADTICIGYHANNSTDTVDTVLEKNVTVTHSVNLLEDSHNGKLCRLKGIAPLQLGNCSIAGWILGNPECESLFSKESWSYIAETPNSENGTCYPGYFADYEELREQLSSVSSFERFEIFPKESSWPNHTVTKGVTAACSHNGKSSFYRNLLWLTEKYGLYPNLSKSYVNNKEKEVLVLWGVHHPSNIGDQRAIYHTENAYVSVVSSHYSRRFTPEIAKRPKVRGQEGRIEYYWTLLEPGDTIIFEANGNLIAPWYAFALSRGFGSGIITSNASMDECDAKCQTPQGAINSSLPFQNVHPVTIGECPKYVRSTKLRMVTGLRNIPSVQSRGLFGAIAGFIEGGWTGMIDGWYGYHHQNEQGSGYAADQKSTQNAINGITNKVNSVIEKMNTQFTAVGKEFNKLERRMENLNKKVDDGFLDIWTYNAELLVLLENERTLDFHDSNVKNLYEKVKSQLKNNAKEIGNGCFEFYHKCNNECMESVKNGTYDYPKYSEESKLNREKIDGVKLESMGVYQILAIYSTVASSLVLLVSLGAISFWMCSNGSLQCRICI,MKAKLLVLLCAFTATDADTICIGYHANNSTDTVDTVLEKNVTVTHSVNLLEDSHNGKLCRLKGIAPLQLGNCSIAGWILGNPECESLFSKESWSYIAETPNSENGTCYPGYFADYEELREQLSSVSSFERFEIFPKESSWPNHTVTKGVTAACSHNGKSSFYRNLLWLTEKNGLYPNLSKSYVNNKEKEVLVLWGVHHPSNIGDQRAIYHTENAYVSVVSSHYSRRFTPEIAKRPKVRGQEGRINYYWTLLEPGDTIIFEANGNLIAPWYAFALSRGFGSGIITSNASMDECDAKCQTPQGAINSSLPFQNVHPVTIGECPKYVRSTKLRMVTGLRNIPSVQSRGLFGAIAGFIEGGWTGMIDGWYGYHHQNEQGSGYAADQKSTQNAINGITNKVNSVIEKMNTQFTAVGKEFNKLERRMENLNEKVDDGFLDIWTYNAELLVLLENERTLDFHDSNVKNLYEKVKSQLKNNAKEIGNGCFEFYHKCNNECMESVKNGTYDYPKYSEESKLNREKIDGVKLESMGVYQILAIYSTVASSLVLLVSLGAISFWMCSNGSLQCRICI,MKAKLLVLLCAFTATDADTICIGYHANNSTDTVDTVLEKNVTVTHSVNLLEDSHNGKLCRLKGIAPLQLGNCSIAGWILGNPECESLFSKESWSYIAETPNSENGTCYPGYFADYEELREQLSSVSSFERFEIFPKESSWPNHTVTKGVTAACSHNGKSSFYRNLLWLTEKNGLYPNLSKSYVNNKEKEVLVLWGVHHPSNIGDQRAIYHTENAYVSVVSSHYSRRFTPEIAKRPKVRGQEGRINYYWTLLEPGDTIIFEANGNLIAPWYAFALSRGFGSGIITSNASMDECDAKCQTPQGAINSSLPFQNVHPVTIGECPKYVRSTKLRMVTGLRNIPSVQSRGLFGAIAGFIEGGWTGMIDGWIGYHHQNEQGSGYAADQKSTQNAINGITNKVNSVIEKMNTQFTAVGKEFNKLERRMENLNKKVDDGFLDIWTYNAELLVLLENERTLDFHDSNVKNLYEKVKSQLKNNAKEIGNGCFEFYHKCNNECMESVKNGTYDYPKYSEESKLNREKIDGVKLESMGVYQILAIYSTVASSLVLLVSLGAISFWMCSNGSLQCRICI,MKAKLLVLLCAFTATDADTICIGYHANNSTDTVDTVLEKNVTVTHSVNLLEDSHNGKLCRLKGIAPLQLGNCSIAGWILGNPECESLFSKESWSYIAETPNSENGTCYPGYFADYEELREQLSSVSSFERFEIFPKESSWPNHTVTKGVTAACSHNGKSSFYRNLLWLTEKNGLYPNLSKSYVNNKEKEVLVLWGVHHPSNIGDQRAIYHTENAYVSVVSSHYSRRFTPEIAKRPKVRGQEGRINYYWTLLEPGDTIIFEANGNLIAPWYAFALSRGFGSGIITSNAIMDECDAKCQTPQGAINSSLPFQNVHPVTIGECPKYVRSTKLRMVTGLRNIPSVQSRGLFGAIAGFIEGGWTGMIDGWYGYHHQNEQGSGYAADQKSTQNAINGITNKVNSVIEKMNTQFTAVGKEFNKLERRMENLNKKVDDGFLDIWTYNAELLVLLENERTLDFHDSNVKNLYEKVKSQLKNNAKEIGNGCFEFYHKCNNECMESVKNGTYDYPKYSEESKLNREKIDGVKLESMGVYQILAIYSTVASSLVLLVSLGAISFWMCSNGSLQCRICI,MKAKLLVLLCAFTATDADTICIGYHANNSTDTVDTVLEKNVTVTHSVNLLEDSHNGKLCRLKGIAPLQLGNCSIAGWILGNPECESLFSKESWSYIAETPNSENGTCYPGYFADYEELREQLSSVSSFERFEIFPKESSWPNHTVTKGVTAACSHNGKSSFYRNLLWLTEKNGLYPNLSKSYVNNKEKEVLVLWGVHHPSNIGDQRAIYHTENAYVSVVSSHYSRRFTPEIAKRPKVRGQEGRINYYWTLLEPGDTIIFEANGNLIAPWYAFALSRGFGSGIITSNASMDECDAKCQTPQGAINSSLPFFNVHPVTIGECPKYVRSTKLRMVTGLRNIPSVQSRGLFGAIAGFIEGGWTGMIDGWYGYHHQNEQGSGYAADQKSTQNAINGITNKVNSVIEKMNTQFTAVGKEFNKLERRMENLNKKVDDGFLDIWTYNAELLVLLENERTLDFHDSNVKNLYEKVKSQLKNNAKEIGNGCFEFYHKCNNECMESVKNGTYDYPKYSEESKLNREKIDGVKLESMGVYQILAIYSTVASSLVLLVSLGAISFWMCSNGSLQCRICI,MKAKLLVLLCAFTATDADTICIGYHANNSTDTVDTVLEKNVTVTHSVNLLEDSHNGKLCRLKGIAPLQLGNCSIAGWILGNPECESLFSKESWSYIAETPNSENGTCYPGYFADYEELREQLSSVSSFERFEIFPKESSWPNHTVTKGVTAACSHNGKSSFYRNLLWLTEKNGLYPNLSKSYVNNKEKEVLVLWGVHHPSNIGDQRAIYHTENAYVSVVSSHYSRRFTPEIAKRPKVRGQEGRINYYWTLLEPGDTIIFEANGNLIAPWYAFALSRGFGSGIITSNASMDECDTKCQTPQGAINSSLPFQNVHPVTIGECPKYVRSTKLRMVTGLRNIPSVQSRGLFGAIAGFIEGGWTGMIDGWYGYHHQNEQGSGYAADQKSTQNAINGITNKVNSVIEKMNTQFTAVGKEFNKLERRMENLNKKVDDGFLDIWTYNAELLVLLENERTLDFHDSNVKNLYEKVKSQLKNNAKEIGNGCFEFYHKCNNECMESVKNGTYDYPKYSEESKLNREKIDGVKLESMGVYQILAIYSTVASSLVLLVSLGAISFWMCSNGSLQCRICI,Other,Total
0.0,0,0,0,0,0,0,0,0,0
2.0,0,0,0,0,0,0,0,0,0
4.0,0,0,0,0,0,0,0,0,0
6.0,0,0,0,0,0,0,0,0,0
8.0,0,0,0,0,0,0,0,0,0
10.0,0,0,0,0,0,0,0,0,0
12.0,0,0,0,0,0,0,0,2,2
14.0,0,0,0,0,0,0,0,4,4
16.0,2,0,0,0,0,0,0,10,12
18.0,10,0,0,0,0,0,0,24,34
20.0,22,2,0,2,0,0,0,42,68
22.0,36,2,0,2,0,0,0,74,114
24.0,48,2,0,2,0,0,0,114,166
26.0,60,2,0,2,0,0,0,168,232
28.0,66,2,2,2,0,0,2,190,264
30.0,76,2,2,2,0,0,2,216,300
32.0,80,2,2,2,0,0,2,234,322
34.0,84,2,2,2,0,0,2,256,348
36.0,86,2,2,2,0,0,2,266,360
38.0,88,2,2,2,0,0,2,288,384
40.0,88,2,2,2,0,0,2,296,392
42.0,90,2,2,2,0,0,2,304,402
44.0,90,2,2,2,0,0,2,314,412
46.0,92,2,2,2,2,0,2,316,418
48.0,92,2,2,2,2,0,2,316,418
50.0,98,2,2,2,2,0,2,324,432
52.0,98,2,2,2,2,2,2,326,436
54.0,100,2,2,2,2,2,2,332,444
56.0,100,2,2,2,2,2,2,332,444
58.0,100,2,2,2,2,2,2,336,448
60.0,102,2,2,2,2,2,2,336,450
62.0,104,2,2,2,2,2,2,336,452
64.0,104,2,2,2,2,2,2,338,454
66.0,104,2,2,2,2,2,2,338,454
68.0,104,2,2,2,2,2,2,338,454
70.0,104,2,2,2,2,2,2,338,454
72.0,104,2,2,2,2,2,2,338,454
74.0,104,2,2,2,2,2,2,338,454
76.0,104,2,2,2,2,2,2,338,454
78.0,104,2,2,2,2,2,2,338,454
80.0,104,2,2,2,2,2,2,338,454
82.0,104,2,2,2,2,2,2,338,454
84.0,104,2,2,2,2,2,2,338,454
86.0,104,2,2,2,2,2,2,338,454
88.0,104,2,2,2,2,2,2,338,454
90.0,104,2,2,2,2,2,2,338,454
92.0,104,2,2,2,2,2,2,338,454
94.0,104,2,2,2,2,2,2,338,454
96.0,104,2,2,2,2,2,2,338,454
98.0,104,2,2,2,2,2,2,338,454
100.0,104,2,2,2,2,2,2,338,454
102.0,104,2,2,2,2,2,2,338,454
104.0,104,2,2,2,2,2,2,338,454
106.0,104,2,2,2,2,2,2,338,454
108.0,104,2,2,2,2,2,2,338,454
110.0,104,2,2,2,2,2,2,338,454
112.0,104,2,2,2,2,2,2,338,454
114.0,104,2,2,2,2,2,2,338,454
116.0,104,2,2,2,2,2,2,338,454
118.0,104,2,2,2,2,2,2,338,454
120.0,104,2,2,2,2,2,2,338,454
122.0,104,2,2,2,2,2,2,338,454
124.0,104,2,2,2,2,2,2,338,454
126.0,104,2,2,2,2,2,2,338,454
128.0,104,2,2,2,2,2,2,338,454
130.0,104,2,2,2,2,2,2,338,454
132.0,104,2,2,2,2,2,2,338,454
134.0,104,2,2,2,2,2,2,338,454
136.0,104,2,2,2,2,2,2,338,454
138.0,104,2,2,2,2,2,2,338,454
140.0,104,2,2,2,2,2,2,338,454
142.0,104,2,2,2,2,2,2,338,454
144.0,104,2,2,2,2,2,2,338,454
146.0,104,2,2,2,2,2,2,338,454
148.0,104,2,2,2,2,2,2,338,454
150.0,104,2,2,2,2,2,2,338,454
152.0,104,2,2,2,2,2,2,338,454
154.0,104,2,2,2,2,2,2,338,454
156.0,104,2,2,2,2,2,2,338,454
158.0,104,2,2,2,2,2,2,338,454
160.0,104,2,2,2,2,2,2,338,454
162.0,104,2,2,2,2,2,2,338,454
164.0,104,2,2,2,2,2,2,338,454
166.0,104,2,2,2,2,2,2,338,454
168.0,104,2,2,2,2,2,2,338,454
170.0,104,2,2,2,2,2,2,338,454
172.0,104,2,2,2,2,2,2,338,454
174.0,104,2,2,2,2,2,2,338,454
176.0,104,2,2,2,2,2,2,338,454
178.0,104,2,2,2,2,2,2,338,454
180.0,104,2,2,2,2,2,2,338,454
182.0,104,2,2,2,2,2,2,338,454
184.0,104,2,2,2,2,2,2,338,454
186.0,104,2,2,2,2,2,2,338,454
188.0,104,2,2,2,2,2,2,338,454
190.0,104,2,2,2,2,2,2,338,454
192.0,104,2,2,2,2,2,2,338,454
194.0,104,2,2,2,2,2,2,338,454
196.0,104,2,2,2,2,2,2,338,454
198.0,104,2,2,2,2,2,2,338,454
200.0,104,2,2,2,2,2,2,338,454
202.0,104,2,2,2,2,2,2,338,454
204.0,104,2,2,2,2,2,2,338,454
206.0,104,2,2,2,2,2,2,338,454
208.0,104,2,2,2,2,2,2,338,454
210.0,104,2,2,2,2,2,2,338,454
212.0,104,2,2,2,2,2,2,338,454
214.0,104,2,2,2,2,2,2,338,454
216.0,104,2,2,2,2,2,2,338,454
218.0,104,2,2,2,2,2,2,338,454
220.0,104,2,2,2,2,2,2,338,454
222.0,104,2,2,2,2,2,2,338,454
224.0,104,2,2,2,2,2,2,338,454
226.0,104,2,2,2,2,2,2,338,454
228.0,104,2,2,2,2,2,2,338,454
230.0,104,2,2,2,2,2,2,338,454
232.0,104,2,2,2,2,2,2,338,454
234.0,104,2,2,2,2,2,2,338,454
236.0,104,2,2,2,2,2,2,338,454
238.0,104,2,2,2,2,2,2,338,454
240.0,104,2,2,2,2,2,2,338,454
242.0,104,2,2,2,2,2,2,338,454
244.0,104,2,2,2,2,2,2,338,454
246.0,104,2,2,2,2,2,2,338,454
248.0,104,2,2,2,2,2,2,338,454
250.0,104,2,2,2,2,2,2,338,454
252.0,104,2,2,2,2,2,2,338,454
254.0,104,2,2,2,2,2,2,338,454
256.0,104,2,2,2,2,2,2,338,454
258.0,104,2,2,2,2,2,2,338,454
260.0,104,2,2,2,2,2,2,338,454
262.0,104,2,2,2,2,2,2,338,454
264.0,104,2,2,2,2,2,2,338,454
266.0,104,2,2,2,2,2,2,338,454
268.0,104,2,2,2,2,2,2,338,454
270.0,104,2,2,2,2,2,2,338,454
272.0,104,2,2,2,2,2,2,338,454
274.0,104,2,2,2,2,2,2,338,454
276.0,104,2,2,2,2,2,2,338,454
278.0,104,2,2,2,2,2,2,338,454
280.0,104,2,2,2,2,2,2,338,454
282.0,104,2,2,2,2,2,2,338,454
284.0,104,2,2,2,2,2,2,338,454
286.0,104,2,2,2,2,2,2,338,454
288.0,104,2,2,2,2,2,2,338,454
290.0,104,2,2,2,2,2,2,338,454
292.0,104,2,2,2,2,2,2,338,454
294.0,104,2,2,2,2,2,2,338,454
296.0,104,2,2,2,2,2,2,338,454
298.0,104,2,2,2,2,2,2,338,454
300.0,104,2,2,2,2,2,2,338,454
302.0,104,2,2,2,2,2,2,338,454
304.0,104,2,2,2,2,2,2,338,454
306.0,104,2,2,2,2,2,2,338,454
308.0,104,2,2,2,2,2,2,338,454
310.0,104,2,2,2,2,2,2,338,454
312.0,104,2,2,2,2,2,2,338,454
314.0,104,2,2,2,2,2,2,338,454
316.0,104,2,2,2,2,2,2,338,454
318.0,104,2,2,2,2,2,2,338,454
320.0,104,2,2,2,2,2,2,338,454
322.0,104,2,2,2,2,2,2,338,454
324.0,104,2,2,2,2,2,2,338,454
326.0,104,2,2,2,2,2,2,338,454
328.0,104,2,2,2,2,2,2,338,454
330.0,104,2,2,2,2,2,2,338,454
332.0,104,2,2,2,2,2,2,338,454
334.0,104,2,2,2,2,2,2,338,454
336.0,104,2,2,2,2,2,2,338,454
338.0,104,2,2,2,2,2,2,338,454
340.0,104,2,2,2,2,2,2,338,454
342.0,104,2,2,2,2,2,2,338,454
344.0,104,2,2,2,2,2,2,338,454
346.0,104,2,2,2,2,2,2,338,454
348.0,104,2,2,2,2,2,2,338,454
350.0,104,2,2,2,2,2,2,338,454
352.0,104,2,2,2,2,2,2,338,454
354.0,104,2,2,2,2,2,2,338,454
356.0,104,2,2,2,2,2,2,338,454
358.0,104,2,2,2,2,2,2,338,454
360.0,104,2,2,2,2,2,2,338,454
362.0,104,2,2,2,2,2,2,338,454
364.0,104,2,2,2,2,2,2,338,454
