Time,MKAKLLVLLCAFTATDADTICIGYHANNSTDTVDTVLEKNVTVTHSVNLLEDSHNGKLCRLKGIAPLQLGNCSIAGWILGNPECESLFSKESWSYIAETPNSENGTCYPGYFADYEELREQLSSVSSFERFEIFPKESSWPNHTVTKGVTAACSHNGKSSFYRNLLWLTEKNGLYPNLSKSYVNNKEKEVLVLWGVHHPSNIGDQRAIYHTENAYVSVVSSHYSRRFTPEIAKRPKVRGQEGRINYYWTLLEPGDTIIFEANGNLIAPWYAFALSRGFGSGIITSNASMDECDAKCQTPQGAINSSLPFQNVHPVTIGECPKYVRSTKLRMVTGLRNIPSVQSRGLFGAIAGFIEGGWTGMIDGWYGYHHQNEQGSGYAADQKSTQNAINGITNKVNSVIEKMNTQFTAVGKEFNKLERRMENLNKKVDDGFLDIWTYNAELLVLLENERTLDFHDSNVKNLYEKVKSQLKNNAKEIGNGCFEFYHKCNNECMESVKNGTYDYPKYSEESKLNREKIDGVKLESMGVYQILAIYSTVASSLVLLVSLGAISFWMCSNGSLQCRICI,MKAKLLVLLCAFTATDADTICIGYHANNSTDTVDTVLEKNVTVTHSVNLLEDSHNGKLCRLKGIAPLQLGNCSIAGWILGNPECEHLFSKESWSYIAETPNSENGTCYPGYFADYEELREQLSSVSSFERFEIFPKESSWPNHTVTKGVTAACSHNGKSSFYRNLLWLTEKNGLQPNLSKSYVNNKEKEVLVLWGVHHPSNIGDQRAIYHTENAYVSVVSSHYSRRFTPEIAKRPKVRGQEGRINYYWTLLEPGDTIIFEANGNLIAPWYAFALSRGFGSGIITSNASMDECDAKCQTPQGAINSSLPFQNVHPVTIGECPKYVRSTKLRMVTGLRNIPSVQSRGLFGAIAGFIEGGWTGMIDGWYGYHHQNEQGSGYAADQKSTQNAINGITNKVNSVIEKMNTQFTAVGKEFNKLERRMENLNKKVDDGFLDIWTYNAELLVLLENERTLDFHDSNVKNLYEKVKSQLKNNAKEIGNGCFEFYHKCNNECMESVKNGTYDYPKYSEESKLNREKIDGVKLESMGVYQILAIYSTVASSLVLLVSLGAISFWMCSNGSLQCRICI,MKAKLLVLLCAFTATCADTICIGYHANNSTDTVDTVLEKNVTVTHSVNLLEDSHNGKLCRLKGIAPLQLGNCSIAGWILGNPECESLFSKESWSYIAETPNSENGTCYPGYFADYEELREQLSSVSSFERFEIFPKESSWPNHTVTKGVTAACSHNGKSSFYRNLLWLTEKNGLYPNLSKSYVNNKEKEVLVLWGVHHPSNIGDQRAIYHTENAYVSVVSSHYSRRFTPEIAKRPKVRGQEGRINYYWTLLEPGDTIIFEANGNLIAPWYAFALSRGFGSGIITSNASMDECDAKCQTPQGAINSSLPFQNVHPVTIGECPKYVRSTKLRMVTGLRNIPSVQSRGLFGAIAGFIEGGWTGMIDGWYGYHHQNEQGSGYAADQKSTQNAINGITNKVNSVIEKMNTQFTAVGKEFNKLERRTENLNKKVDDGFLDIWTYNAELLVLLENERTLDFHDSNVKNLYEKVKSQLKNNAKEIGNGCFEFYDKCNNECMESVKNGTYDYPKYSEESKLNREKIDGVKLESMGVYQILAIYSTVASSLVLLVSLGAISFWMCSNGSLQCRICI,MKAKLLVLLCAFTATDADTICIGYHANNSTDTVDTVLEKNVTVTHSVNLLEDSHNGKLCRLKGIAPLQLGNCSIAGWILGNPECESLFSKESWSYIAETPNSENGTCYPGYFADYEELREQLSSVSSFERFEIFPKESSWPNHTVTKGVTAACSHNGKSSFYRNLLWLTEKNGLYPNLSKSYVNNKEKEVLVLWGVHHPSNIGDQRAIYHTENAYVSVVSSHYSRRFTPEIAKRPKVRGQEGRINYYWTLLEPGDTIIFEANGNLIAPWYAFALSRGFGSGIITSNASMDECDAKCQTPQGAINSSLPFQNVHPVTIGECPKYVRSTKLRMVTGLRNIPSVQSRGLFGAIAGFIEGGWTGMIDGWYGYHHQNEQGSGYAADQKSTQNAINGITNKVNSVIEKMNTQFTAVGKEFNKLERRMENLNKKVDDGFLDIWTYNAELLVLLENERTLDFHDSNVKNLYEKVKSQLKNNAKEIGNGCFEFYHKCNNECMESVKNGTYDYPKYSEESKLNREKIDGVKLESMGVYQILAIYSTVASWLVLLVSLGAISFWMCSNGSLQCRICI,MKAKLLVLLCAFTATDADTICIGYHANNSTDTVDTVLEKNVTVTHSVNLLEDSHNGKLCRLKGIAPLQVGNCSIAGWILGNPECESLFSKESWSYIAETPNSENGTCYPGYFADYEELREQLSSVSSFERFEIFPKESSWPMHTVTKGVTAACSHNGKSCFYRNLLWLTEKNGLYPNLSKSYVNNKEKEVLVLWGVHHPSNIGDQRAIYHTENAYVSVVSSHYSRRFTPEIAKRPKVRGQEGRINYYWTLLEPGDTIIFEANGNLIAPWYAFALSRGFGSGIITSNASMDECDAKCQTPQGAINSSLPFQNVHPVTIGECPKYVRSTKLRMVTGLRNIPSVQSRGLFGAIAGFIEGGWTGMIDGWYGYHHQNEQGSGYAADQKSTQNAINGITNKVNSVIEKMNTQFTAVGKEFNKLERRMENLNKKVDDGFLDIWTYNAELLVLLENERTLDFHDSNVKNLYEKVKSQLKNNAKEIGNGCFEFYHKCNNECMESVKNGTYDYPKYSFESKLNREKIDGVKLESMGVYQILAIYSTVASSLVLLVSLGAISFWMCSNGSLQCRICI,MKAKLLVLLCAFTATDADTICIGYHANNSTDTVDTVLEKNVTVTHSVNLLEDSHNGKLCRLKGIAPLQLGNCSIAGWILGNPECESLFSKESWSYIAETPNSENGTCYPGYFADYEELREQLSSVSSFERFEIFPKESSWPNHTVTKGVTAACSHNGKSSFYRNLLWLTEKNGLYPNLSKSYMNNKEKEVLVLWGVHHPSNIGDQRAIYHTENAYVSVVSSHYSRRFTPERAKRPKVRGQEGRINYYWTLLEPGDTIIFEANGNLIAYWYAFALSRGFGSGIITSNASMDECDAKCQTPQGAINSSLPFQNVHPVTIGECPKYVRSTKLRMVTPLRNIPSVQSRGLFGAIAGFIEGGWTGMIDGWYGYHHQNEQGSGYAADQKSTQNAINGITNKVNSVIEKMNTQFTAVGKEFNKLERRMENLNKKVDDGFLDIWTYNAELLVLLENERTLDFHDSNVKNLYEKVKSQLKNNAKEIGNGCFEFYHKCNNECMESVKNGTYDYPKYSEESKLNREKIDGVKLESMGVYQILAIYSTVASSLVLLVSLGAISFWMCSNGSLQCRICI,MKAKLLVLLCAFTATDADTICIGYHANNSTDTVDTVLEKNVTVTHSVNLLEDSHNGKLCRLKGIAPLQLGNCSIAGWILGNPECESLFSKESWSYIAETPNSENGTCYPGYFADYEELREQLSSVSSFERFEIFPKESSWPNHTVTKGVTAACSHNGKSSFYRNLLWLTEKNGLYPNLSKSYVNNKEKEVLVLWGVHHPSNIGDQRAIYHTENAYVSVVSSHYSRRFTPEIAKRPKVRGQEGRINYYWTLLEPGDTIIFEANGNLIAPWYAFALSRGFGSGIITSNASMDECDAKCQTPQGAINSSLPFQNVHPVTIGECPKYVRSTKLRMVTGLRNIPSVQSRGLFGAIAGFIEGGWTGMIDGWYGYHHQNEQGSGYAADQKSTQNAINGITNKVNSVIEKMNTQFTAVGKEFNKLERRMENLNKKVDDGFLDIWTSNAELLVLLENERTLDFHDSNVKNLYEKVKSQLKNNAKEIGNGCFEFYHKCNNECMESVKNGTYDYPKYSEESKLNREKIDGVKLESMGVYQILAIYSTVASSLVLLVSLGAISFWMCSNGSLQCRICI,Other,Total
0.0,0,0,0,0,0,0,0,0,0
2.0,0,0,0,0,0,0,0,0,0
4.0,0,0,0,0,0,0,0,0,0
6.0,0,0,0,0,0,0,0,0,0
8.0,0,0,0,0,0,0,0,0,0
10.0,2,0,0,0,0,0,0,0,2
12.0,2,0,0,0,0,0,0,0,2
14.0,2,0,0,0,0,0,0,0,2
16.0,2,0,0,0,0,0,0,4,6
18.0,4,0,0,0,0,0,2,8,14
20.0,12,0,0,0,0,0,2,26,40
22.0,24,0,0,2,0,0,2,66,94
24.0,40,0,0,2,0,2,2,100,146
26.0,50,0,0,2,0,2,2,142,198
28.0,56,0,0,2,0,2,2,168,230
30.0,60,0,0,2,0,2,2,192,258
32.0,64,0,0,2,0,2,2,214,284
34.0,68,0,0,2,0,2,2,230,304
36.0,70,0,2,2,0,2,2,246,324
38.0,72,0,2,2,0,2,2,256,336
40.0,74,0,2,2,2,2,2,264,348
42.0,74,0,2,2,2,2,2,276,360
44.0,74,0,2,2,2,2,2,284,368
46.0,74,0,2,2,2,2,2,290,374
48.0,74,2,2,2,2,2,2,292,378
50.0,74,2,2,2,2,2,2,296,382
52.0,76,2,2,2,2,2,2,300,388
54.0,76,2,2,2,2,2,2,302,390
56.0,76,2,2,2,2,2,2,306,394
58.0,76,2,2,2,2,2,2,306,394
60.0,76,2,2,2,2,2,2,306,394
62.0,76,2,2,2,2,2,2,306,394
64.0,76,2,2,2,2,2,2,306,394
66.0,76,2,2,2,2,2,2,306,394
68.0,76,2,2,2,2,2,2,306,394
70.0,76,2,2,2,2,2,2,306,394
72.0,76,2,2,2,2,2,2,308,396
74.0,76,2,2,2,2,2,2,308,396
76.0,76,2,2,2,2,2,2,308,396
78.0,76,2,2,2,2,2,2,308,396
80.0,76,2,2,2,2,2,2,308,396
82.0,76,2,2,2,2,2,2,308,396
84.0,76,2,2,2,2,2,2,308,396
86.0,76,2,2,2,2,2,2,308,396
88.0,76,2,2,2,2,2,2,308,396
90.0,76,2,2,2,2,2,2,308,396
92.0,76,2,2,2,2,2,2,308,396
94.0,76,2,2,2,2,2,2,308,396
96.0,76,2,2,2,2,2,2,308,396
98.0,76,2,2,2,2,2,2,308,396
100.0,76,2,2,2,2,2,2,308,396
102.0,76,2,2,2,2,2,2,308,396
104.0,76,2,2,2,2,2,2,308,396
106.0,76,2,2,2,2,2,2,308,396
108.0,76,2,2,2,2,2,2,308,396
110.0,76,2,2,2,2,2,2,308,396
112.0,76,2,2,2,2,2,2,308,396
114.0,76,2,2,2,2,2,2,308,396
116.0,76,2,2,2,2,2,2,308,396
118.0,76,2,2,2,2,2,2,308,396
120.0,76,2,2,2,2,2,2,308,396
122.0,76,2,2,2,2,2,2,308,396
124.0,76,2,2,2,2,2,2,308,396
126.0,76,2,2,2,2,2,2,308,396
128.0,76,2,2,2,2,2,2,308,396
130.0,76,2,2,2,2,2,2,308,396
132.0,76,2,2,2,2,2,2,308,396
134.0,76,2,2,2,2,2,2,308,396
136.0,76,2,2,2,2,2,2,308,396
138.0,76,2,2,2,2,2,2,308,396
140.0,76,2,2,2,2,2,2,308,396
142.0,76,2,2,2,2,2,2,308,396
144.0,76,2,2,2,2,2,2,308,396
146.0,76,2,2,2,2,2,2,308,396
148.0,76,2,2,2,2,2,2,308,396
150.0,76,2,2,2,2,2,2,308,396
152.0,76,2,2,2,2,2,2,308,396
154.0,76,2,2,2,2,2,2,308,396
156.0,76,2,2,2,2,2,2,308,396
158.0,76,2,2,2,2,2,2,308,396
160.0,76,2,2,2,2,2,2,308,396
162.0,76,2,2,2,2,2,2,308,396
164.0,76,2,2,2,2,2,2,308,396
166.0,76,2,2,2,2,2,2,308,396
168.0,76,2,2,2,2,2,2,308,396
170.0,76,2,2,2,2,2,2,308,396
172.0,76,2,2,2,2,2,2,308,396
174.0,76,2,2,2,2,2,2,308,396
176.0,76,2,2,2,2,2,2,308,396
178.0,76,2,2,2,2,2,2,308,396
180.0,76,2,2,2,2,2,2,308,396
182.0,76,2,2,2,2,2,2,308,396
184.0,76,2,2,2,2,2,2,308,396
186.0,76,2,2,2,2,2,2,308,396
188.0,76,2,2,2,2,2,2,308,396
190.0,76,2,2,2,2,2,2,308,396
192.0,76,2,2,2,2,2,2,308,396
194.0,76,2,2,2,2,2,2,308,396
196.0,76,2,2,2,2,2,2,308,396
198.0,76,2,2,2,2,2,2,308,396
200.0,76,2,2,2,2,2,2,308,396
202.0,76,2,2,2,2,2,2,308,396
204.0,76,2,2,2,2,2,2,308,396
206.0,76,2,2,2,2,2,2,308,396
208.0,76,2,2,2,2,2,2,308,396
210.0,76,2,2,2,2,2,2,308,396
212.0,76,2,2,2,2,2,2,308,396
214.0,76,2,2,2,2,2,2,308,396
216.0,76,2,2,2,2,2,2,308,396
218.0,76,2,2,2,2,2,2,308,396
220.0,76,2,2,2,2,2,2,308,396
222.0,76,2,2,2,2,2,2,308,396
224.0,76,2,2,2,2,2,2,308,396
226.0,76,2,2,2,2,2,2,308,396
228.0,76,2,2,2,2,2,2,308,396
230.0,76,2,2,2,2,2,2,308,396
232.0,76,2,2,2,2,2,2,308,396
234.0,76,2,2,2,2,2,2,308,396
236.0,76,2,2,2,2,2,2,308,396
238.0,76,2,2,2,2,2,2,308,396
240.0,76,2,2,2,2,2,2,308,396
242.0,76,2,2,2,2,2,2,308,396
244.0,76,2,2,2,2,2,2,308,396
246.0,76,2,2,2,2,2,2,308,396
248.0,76,2,2,2,2,2,2,308,396
250.0,76,2,2,2,2,2,2,308,396
252.0,76,2,2,2,2,2,2,308,396
254.0,76,2,2,2,2,2,2,308,396
256.0,76,2,2,2,2,2,2,308,396
258.0,76,2,2,2,2,2,2,308,396
260.0,76,2,2,2,2,2,2,308,396
262.0,76,2,2,2,2,2,2,308,396
264.0,76,2,2,2,2,2,2,308,396
266.0,76,2,2,2,2,2,2,308,396
268.0,76,2,2,2,2,2,2,308,396
270.0,76,2,2,2,2,2,2,308,396
272.0,76,2,2,2,2,2,2,308,396
274.0,76,2,2,2,2,2,2,308,396
276.0,76,2,2,2,2,2,2,308,396
278.0,76,2,2,2,2,2,2,308,396
280.0,76,2,2,2,2,2,2,308,396
282.0,76,2,2,2,2,2,2,308,396
284.0,76,2,2,2,2,2,2,308,396
286.0,76,2,2,2,2,2,2,308,396
288.0,76,2,2,2,2,2,2,308,396
290.0,76,2,2,2,2,2,2,308,396
292.0,76,2,2,2,2,2,2,308,396
294.0,76,2,2,2,2,2,2,308,396
296.0,76,2,2,2,2,2,2,308,396
298.0,76,2,2,2,2,2,2,308,396
300.0,76,2,2,2,2,2,2,308,396
302.0,76,2,2,2,2,2,2,308,396
304.0,76,2,2,2,2,2,2,308,396
306.0,76,2,2,2,2,2,2,308,396
308.0,76,2,2,2,2,2,2,308,396
310.0,76,2,2,2,2,2,2,308,396
312.0,76,2,2,2,2,2,2,308,396
314.0,76,2,2,2,2,2,2,308,396
316.0,76,2,2,2,2,2,2,308,396
318.0,76,2,2,2,2,2,2,308,396
320.0,76,2,2,2,2,2,2,308,396
322.0,76,2,2,2,2,2,2,308,396
324.0,76,2,2,2,2,2,2,308,396
326.0,76,2,2,2,2,2,2,308,396
328.0,76,2,2,2,2,2,2,308,396
330.0,76,2,2,2,2,2,2,308,396
332.0,76,2,2,2,2,2,2,308,396
334.0,76,2,2,2,2,2,2,308,396
336.0,76,2,2,2,2,2,2,308,396
338.0,76,2,2,2,2,2,2,308,396
340.0,76,2,2,2,2,2,2,308,396
342.0,76,2,2,2,2,2,2,308,396
344.0,76,2,2,2,2,2,2,308,396
346.0,76,2,2,2,2,2,2,308,396
348.0,76,2,2,2,2,2,2,308,396
350.0,76,2,2,2,2,2,2,308,396
352.0,76,2,2,2,2,2,2,308,396
354.0,76,2,2,2,2,2,2,308,396
356.0,76,2,2,2,2,2,2,308,396
358.0,76,2,2,2,2,2,2,308,396
360.0,76,2,2,2,2,2,2,308,396
362.0,76,2,2,2,2,2,2,308,396
364.0,76,2,2,2,2,2,2,308,396
